Admurai - Miau Rad
Amonitas - Satan Omi
Ampharos - Opas Rahm
Bamelin - bin lame
Banette - anbetet
Barschuft - Frachtbus
Barschwa - waschbar
Bisaknosp - Boss Panik
Blanas - anblas
Bollterus - los Butler
Botogel - Bootleg
Brutalanda - Landbau Rat
Burmadame - Dammbauer
Caesurio - ciao User
Chaneira - Anarchie
Chelast - Stachel
Demeteros - Meeres Tod
Dragoran - Rad Organ
Draschel - der Lachs
Echnatoll - Hotel Clan
Efoserp - Po Ferse
Elekid - kleide
Emolga - Gel Oma
Entei - Niete
Enton - Tonne
Entoron - Neon Ort
Evoli - Olive
Felino - Folien
Feurigel - ruf Geile
Flamara - Aal Farm
Flapteryx - Party Flex
Flegmon - Gnom Elf
Fleknoil - Kill Ofen
Fletiamo - Omi Falte
Flunschlik - Links Fluch
Folipurba - Laub Profi
Frosdedje - jedes Dorf
Furnifrass - Frisur Fans
Garados - sogar da
Gehweiher - Reh Geweih
Gelatini - anteilig
Gelatwino - Gewalt Ion
Geronimatz - mag Zitrone
Gewaldro - Gold Ware
Glibunkel - King Bulle
Glumanda - Lama Dung
Golbat - Lob Tag
Goldini - Login ID
Heatran - enthaar
Heiteira - Eiter Hai
Hippopotas - Opas Pop Hit
Honweisel - Eisen Wohl
Hornliu - hol Urin
Hundemon - ohne Mund
Hunduster - Uhr Stunde
Hutsassa - aussahst
Impergator - artiger Mop
Impoleon - mein Pool
Kabuto - Kot Bau
Kappalores - rosa Klappe
Karippas - Paprikas
Kaumalat - akut Lama
Kiesling - Igel Skin
Kingler - Kringel
Kleinstein - Ski Entlein
Kleoparda - Parade Klo
Kobalium - Kau Mobil
Laschoking - Koch Signal
Laternecto - erntet Cola
Lavados - das Oval
Ledian - Landei
Ledyba - bald ey
Lektrobal - Rektal Lob
Lichtel - chillte
Loturzel - zurollte
Machollo - cool lahm
Machomei - Echo Mami
Magnayen - gay Namen
Magnetilo - Omi angelt
Magneton - Montagen
Mamolida - Mama Idol
Mamutel - alte Mum
Maskeregen - Gase merken
Matrifol - Flirt Oma
Meditalis - Ideal Mist
Meditie - mit Idee
Meganie - ein Game
Meistagrif - Fertig Mais
Metang - Magnet
Mollimorba - Moral Mobil
Morbitesse - Meteor Biss
Muntier - ein Turm
Muschas - Schmaus
Nagelotz - anglotze
Nasgnet - Stangen
Nebulak - klauben
Panpyro - Pony Rap
Pantimos - imposant
Panzaeron - Ranzen Opa
Papinella - Lappalien
Phione - ohne Pi
Pikachu - Kau Chip
Piondragi - Indigo Rap
Pionskora - Kais Porno
Plaudagei - Audi Plage
Porenta - Patrone
Rameidon - Dioramen
Ramoth - Ohr Amt
Regigigas - Gas gierig
Regirock - rockiger
Registeel - geliertes
Reptain - Piraten
Reshiram - Herr Mais
Rettan - Ratten
Rokkaiman - Makkaroni
Roselia - Loser AI
Roserade - rosa Erde
Samurzel - zum Laser
Schalellos - all solches
Schaloko - Klo Chaos
Scherox - Sex Chor
Schwalbini - ich bins Wal
Schwalboss - bloss Wachs
Seedraking - Sir Gedanke
Seemops - Po Messe
Seeper - Speere
Sengo - sogen
Serpifeu - Sirup Fee
Sesokitz - iss Kotze
Simsala - Salamis
Skorgla - Gras Klo
Sleima - E-Mails
Smettbo - Obst Met
Snobilikat - stabil Kino
Sodamak - das Koma
Spoink/Knospi - so pink
Stalobor - Lars Boot
Starmie - Smartie
Sterndu - dursten
Strawickl - Wal Strick
Strepoli - Spielort
Tangela - Galante
Tangoloss - Solo Angst
Tanhel - halten
Tannza - antanz
Tauboss - aus Obst
Tauros - Autors
Tengulist - net lustig
Tentacha - ach Tante
Terrakium - Kurier Amt
Togekiss - Essig Kot
Togepi - Po Teig
Tragosso - Gas Torso
Trasla - Altars
Traumato - traut Oma
Traunmagil - mal unartig
Trikephalo - Ohr Kapitel
Turtok - Tot Kur
Tuska - kaust
Ursaring - Gras Urin
Voluminas - minus Oval
Yanmega - gay Amen
Zebritz - bezirzt