Bisaknosp - Boss Panik
Glumanda - Lama Dung
Turtok - Tot Kur
Smettbo - Obst Met
Hornliu - hol Urin
Tauboss - aus Obst
Rettan - Ratten
Pikachu - Kau Chip
Golbat - Lob Tag
Snobilikat - stabil Kino
Enton - Tonne
Entoron - Neon Ort
Simsala - Salamis
Machollo - cool lahm
Machomei - Echo Mami
Tentacha - ach Tante
Kleinstein - Ski Entlein
Flegmon - Gnom Elf
Magnetilo - Omi angelt
Magneton - Montagen
Porenta - Patrone
Sleima - E-Mails
Muschas - Schmaus
Nebulak - klauben
Traumato - traut Oma
Kingler - Kringel
Lektrobal - Rektal Lob
Tragosso - Gas Torso
Chaneira - Anarchie
Tangela - Galante
Seeper - Speere
Goldini - Login ID
Sterndu - dursten
Starmie - Smartie
Pantimos - imposant
Tauros - Autors
Garados - sogar da
Evoli - Olive
Flamara - Aal Farm
Amonitas - Satan Omi
Kabuto - Kot Bau
Lavados - das Oval
Dragoran - Rad Organ
Meganie - ein Game
Feurigel - ruf Geile
Impergator - artiger Mop
Ledyba - bald ey
Ledian - Landei
Togepi - Po Teig
Ampharos - Opas Rahm
Felino - Folien
Laschoking - Koch Signal
Tannza - antanz
Skorgla - Gras Klo
Scherox - Sex Chor
Ursaring - Gras Urin
Botogel - Bootleg
Panzaeron - Ranzen Opa
Hunduster - Uhr Stunde
Hundemon - ohne Mund
Seedraking - Sir Gedanke
Elekid - kleide
Heiteira - Eiter Hai
Entei - Niete
Reptain - Piraten
Gewaldro - Gold Ware
Magnayen - gay Namen
Schaloko - Klo Chaos
Papinella - Lappalien
Loturzel - zurollte
Kappalores - rosa Klappe
Samurzel - zum Laser
Blanas - anblas
Tengulist - net lustig
Schwalbini - ich bins Wal
Schwalboss - bloss Wachs
Trasla - Altars
Gehweiher - Reh Geweih
Maskeregen - Gase merken
Muntier - ein Turm
Nasgnet - Stangen
Meditie - mit Idee
Meditalis - Ideal Mist
Roselia - Loser AI
Spoink/Knospi - so pink
Tuska - kaust
Sengo - sogen
Barschwa - waschbar
Banette - anbetet
Seemops - Po Messe
Draschel - der Lachs
Brutalanda - Landbau Rat
Tanhel - halten
Metang - Magnet
Regirock - rockiger
Registeel - geliertes
Chelast - Stachel
Panpyro - Pony Rap
Impoleon - mein Pool
Roserade - rosa Erde
Rameidon - Dioramen
Bollterus - los Butler
Burmadame - Dammbauer
Honweisel - Eisen Wohl
Bamelin - bin lame
Schalellos - all solches
Traunmagil - mal unartig
Plaudagei - Audi Plage
Kaumalat - akut Lama
Hippopotas - Opas Pop Hit
Pionskora - Kais Porno
Piondragi - Indigo Rap
Glibunkel - King Bulle
Tangoloss - Solo Angst
Togekiss - Essig Kot
Yanmega - gay Amen
Folipurba - Laub Profi
Mamutel - Team Ulm
Voluminas - minus Oval
Frosdedje - jedes Dorf
Heatran - enthaar
Regigigas - Gas gierig
Phione - ohne Pi
Serpifeu - Sirup Fee
Efoserp - Po Ferse
Admurai - Miau Rad
Nagelotz - anglotze
Kleoparda - Parade Klo
Sodamak - das Koma
Zebritz - bezirzt
Kiesling - Igel Skin
Fleknoil - Kill Ofen
Fletiamo - Omi Falte
Stalobor - Lars Boot
Strepoli - Spielort
Meistagrif - Fertig Mais
Strawickl - Wal Strick
Matrifol - Flirt Oma
Barschuft - Frachtbus
Rokkaiman - Makkaroni
Echnatoll - Hotel Clan
Karippas - Paprikas
Flapteryx - Party Flex
Mollimorba - Moral Mobil
Morbitesse - Meteor Biss
Gelatini - anteilig
Gelatwino - Gewalt Ion
Sesokitz - iss Kotze
Emolga - Gel Oma
Hutsassa - aussahst
Mamolida - Mama Idol
Lichtel - chillte
Laternecto - erntet Cola
Flunschlik - Links Fluch
Caesurio - ciao User
Geronimatz - mag Zitrone
Furnifrass - Frisur Fans
Trikephalo - Ohr Kapitel
Ramoth - Ohr Amt
Kobalium - Kau Mobil
Terrakium - Kurier Amt
Reshiram - Herr Mais
Demeteros - Meeres Tod